.,.,.,.,R,.
X,#,#,#,#,#
X,.,.,.,X,v
X,.,X,.,X,.
X,.,X,.,X,.
.,.,X,.,X,.
#,.,X,.,.,.
#,.,#,#,#,#
.,.,.,.,.,.
