#,X,X,X,X,X,#,#,#
X,.,.,R,.,.,=,w,R
X,w,#,#,#,#,.,w,#
X,.,.,.,X,#,#,w,.
X,.,X,.,X,v,#,.,.
X,.,X,.,X,.,#,.,.
.,.,X,.,X,.,#,.,.
#,.,X,.,.,.,#,.,.
#,.,#,#,#,#,#,.,.
#,.,.,.,.,.,.,.,.
#,#,#,#,#,.,.,.,.
.,.,.,.,.,.,.,.,.
