.,w,w,w,=,#,.,.,.,.,.,.,#,.
.,#,#,=,=,#,.,#,#,.,.,.,#,.
.,.,#,#,.,#,.,.,#,R,.,#,#,.
.,.,.,#,.,#,#,.,#,R,.,#,.,.
.,.,.,#,.,.,#,#,#,#,.,#,.,.
.,.,.,#,.,.,.,.,.,.,.,#,.,.
.,.,.,#,#,#,#,#,#,#,#,#,.,.
.,.,.,.,.,.,^,.,.,.,.,.,.,.
