.,.,.,R,.,.
.,#,#,#,#,.
.,#,.,.,.,#
#,.,#,#,#,.
#,.,.,.,.,.
#,.,#,#,#,#
#,.,#,^,.,#
#,.,.,.,.,#
