.,X,X,X,X,X,X,X,X,X,.
.,R,R,R,R,R,R,R,R,R,X
X,w,w,w,w,w,w,w,w,w,X
X,.,.,w,w,w,w,w,w,w,X
X,.,w,w,w,w,w,w,w,w,X
X,R,w,w,w,w,w,w,w,w,X
X,#,#,X,X,X,X,w,w,w,X
X,X,X,#,#,#,#,w,w,w,X
X,w,w,w,w,w,w,w,w,w,X
X,w,w,X,X,w,^,w,w,.,X
X,w,w,w,w,w,w,w,R,.,X
.,X,X,X,X,X,X,X,X,X,.
