.,.,X,X,X,X,X,X,X,X
#,1,#,#,.,.,.,.,#,R
w,1,.,.,.,.,.,.,#,#
.,.,=,=,.,.,v,.,.,.
=,2,X,#,#,#,#,.,.,3
.,.,#,3,#,R,#,.,.,.
w,w,#,#,X,#,#,.,.,.
X,X,2,.,#,.,.,.,.,.
w,w,#,.,#,.,.,#,#,#
R,R,#,.,#,.,.,#,.,#
w,w,#,.,#,.,.,#,#,.
.,.,.,.,#,.,.,#,.,#
.,.,.,.,w,.,.,.,R,#
