.,.,.,.,w,w,=,.,.,.,.,.
w,w,w,w,w,#,=,.,#,.,.,.
w,1,w,w,1,#,#,.,#,.,.,.
w,.,R,.,#,#,2,.,#,#,.,.
w,#,#,#,#,.,.,#,1,.,.,.
.,.,.,.,.,.,#,#,#,#,#,.
.,.,.,2,.,.,#,.,.,.,.,.
.,.,.,.,.,.,#,.,#,#,#,#
.,.,.,.,.,.,#,.,.,.,.,#
.,.,^,#,#,#,#,#,.,=,.,.
2,.,.,#,.,.,.,#,=,1,=,.
.,.,.,#,.,#,.,#,.,=,.,.
.,.,.,.,.,#,.,.,.,.,.,.
