.,.,.,.,.,2,.,.,.,.
#,X,X,X,X,#,#,X,1,.
R,#,.,.,.,#,R,#,.,.
#,#,.,.,v,#,#,#,.,.
X,#,#,.,.,#,.,.,.,.
2,.,1,.,.,#,.,.,.,.
.,=,#,#,#,#,.,.,.,.
X,X,2,.,.,.,.,.,.,.
w,w,#,.,.,.,.,.,.,.
R,R,#,.,.,.,.,.,.,.
