#,R,#,.,.,.
#,w,#,.,.,.
#,.,#,.,.,.
#,.,#,.,.,.
#,.,#,.,.,.
#,.,#,.,.,.
#,.,#,.,.,.
#,.,#,.,.,.
#,.,#,#,#,#
#,.,.,.,.,.
1,#,1,#,1,.
#,R,#,R,#,.
#,w,#,w,#,.
.,.,#,.,#,.
#,.,.,.,.,.
#,.,#,#,#,#
#,.,#,.,.,.
#,.,#,.,.,.
#,.,#,.,.,.
#,.,#,.,.,.
#,.,#,.,.,.
#,.,.,.,.,.
#,.,#,.,.,.
#,.,#,.,.,.
#,^,#,.,.,.
