.,.,4,.,.,.,.,R,.,#,.,.,.,.,.,.,.,.,.,.
#,#,#,#,#,#,#,#,.,#,.,.,#,#,#,.,.,.,.,.
.,.,.,.,.,.,.,X,#,#,.,#,.,.,.,#,.,.,.,.
X,X,X,X,X,X,X,X,X,#,.,#,.,#,.,#,.,.,.,.
#,#,#,#,#,#,#,#,#,X,#,#,.,#,.,#,#,#,#,#
R,w,4,.,.,.,.,1,w,R,R,#,.,#,.,#,.,X,2,.
w,w,.,.,#,.,#,4,w,#,R,#,.,#,.,#,=,X,#,.
.,.,.,#,.,.,#,#,#,#,#,.,.,#,.,.,=,3,#,C
>,.,.,#,.,1,#,w,.,.,O,O,O,O,O,O,O,O,#,.
.,.,.,4,.,3,1,w,.,.,.,.,.,.,.,w,.,.,2,.
