.,.,#,#,#,#,.,.,.,.,#,#
.,#,R,.,.,#,.,#,#,#,R,.
.,#,#,#,.,#,.,O,O,#,#,.
.,O,#,.,.,#,.,w,O,.,.,.
.,O,#,#,#,#,#,w,O,.,.,.
.,O,O,O,O,O,O,w,O,.,.,.
.,.,.,.,.,^,.,.,.,.,.,.
