#,X,X,X,X,X,#,#,#
X,.,.,R,.,.,.,w,R
X,w,#,#,#,#,.,w,#
X,.,v,.,X,#,#,w,.
X,.,X,X,X,.,#,.,.
X,.,X,w,w,w,#,.,.
.,.,X,w,R,w,#,.,.
#,.,X,w,w,w,#,.,.
#,.,#,#,#,#,#,.,.
#,.,.,.,.,.,.,.,.
#,#,#,#,#,.,.,.,.
.,.,.,.,.,.,.,.,.
