#,#,#,#,#,#,#,#,#,#,X,X,#,#,.
.,X,X,X,X,#,#,.,.,.,2,#,R,3,.
X,.,.,.,w,R,#,.,#,.,.,w,R,3,.
X,.,#,1,#,#,#,.,#,.,.,w,#,.,X
X,.,>,#,#,#,1,.,#,O,w,.,X,4,X
.,X,.,.,.,.,.,.,#,2,#,.,X,.,X
.,#,X,.,.,#,.,.,#,.,w,.,X,.,X
.,#,X,.,w,#,.,.,#,.,w,.,X,.,X
.,#,X,w,w,#,1,.,#,.,w,.,X,.,X
.,#,#,1,w,#,.,.,#,.,#,.,X,.,X
.,#,#,.,w,#,.,.,#,.,#,.,X,.,X
.,#,#,.,w,#,1,.,#,.,#,.,X,4,X
.,#,#,.,w,#,.,#,#,.,#,#,#,.,X
.,#,#,.,w,#,.,#,R,.,#,#,#,.,X
.,#,#,.,w,#,1,.,.,.,.,#,#,.,X
#,#,R,.,O,#,.,.,.,.,.,#,R,.,X
