.,X,X,X,X,#,#,#,#,#,X,X,#,#,.
X,.,.,.,w,R,#,.,.,.,2,#,R,3,.
X,.,#,1,#,#,#,.,.,.,.,w,R,3,.
X,.,>,#,#,1,.,.,.,.,.,#,#,4,X
.,X,.,.,.,.,.,.,#,O,#,.,X,.,X
.,#,X,.,.,#,.,.,#,2,#,.,X,.,X
.,#,X,w,w,#,1,.,#,.,#,.,X,.,X
.,#,#,1,w,#,.,.,#,.,#,.,X,.,X
.,#,#,.,w,#,.,.,#,.,#,.,X,.,X
.,#,#,.,w,#,1,.,#,.,#,.,X,.,X
.,#,#,.,w,#,.,.,#,.,#,.,X,4,X
.,#,#,.,w,#,.,#,#,.,#,#,#,.,X
#,#,R,.,O,#,1,#,R,.,#,#,#,.,X
.,.,.,.,.,.,.,.,.,.,.,#,#,.,X
.,.,.,.,.,.,.,.,.,.,.,#,R,.,X
