R,R,R,R,R,R,R,R,2,1
w,w,w,w,w,w,w,w,X,X
X,X,X,X,X,X,X,X,#,#
.,.,#,#,#,#,#,#,#,R
.,.,w,X,X,#,#,#,w,w
.,.,w,1,1,.,.,.,2,1
.,.,w,X,X,#,#,.,.,w
>,.,w,2,2,.,.,.,.,R
.,.,w,.,#,#,#,O,.,w
.,.,#,w,w,R,#,.,.,w
