.,.,#,.,.,#,R,#,.,.,.,w,R,#
.,#,#,.,.,#,w,#,.,.,.,#,#,4
.,w,R,#,.,#,1,#,.,#,.,.,#,#
.,#,#,#,.,#,.,#,.,#,#,.,.,#
.,.,#,.,#,#,.,#,.,#,#,#,.,#
.,.,#,#,#,.,.,.,.,.,#,#,.,#
.,.,.,.,.,.,.,.,.,.,#,#,.,#
.,.,.,.,.,.,.,.,.,.,#,#,.,#
.,.,.,.,^,.,.,.,.,.,#,.,.,.
#,O,#,.,.,.,.,.,#,#,#,#,#,#
#,1,#,2,.,#,#,#,#,4,#,#,R,R
.,#,#,.,2,.,3,#,#,.,.,.,.,.
O,R,#,.,#,3,w,.,w,.,.,.,.,.
