.,.,3,X,2,X,X,X,X,X
#,#,#,.,.,.,#,R,R,.
w,2,.,.,#,.,#,#,#,.
.,.,#,X,.,.,<,.,#,#
=,1,X,#,#,.,#,.,X,4
.,.,#,3,#,.,#,.,X,3
w,w,#,#,#,.,#,.,X,#
X,X,1,.,.,.,#,.,.,.
w,w,#,.,#,.,#,#,#,w
R,R,#,.,#,.,4,#,.,w
w,w,#,.,#,#,4,#,#,.
.,.,.,.,.,.,.,w,R,#
w,w,#,#,#,#,4,#,4,#
